##############################################################################
#                                                                            #
#                                                                            #
#                                     #####                                  #
#                                    ##   ##                                 #
#                                   ##     ##                                #
#                                   #       #                                #
#                                   #       #                                #
#                                   #       #                                #
#                                   ##     ##                                #
#                                    ##   ##                                 #
#                                     #####                                  #
#                                                                            #
#                                                                            #
##############################################################################
##############################################################################
#                                                                            #
#                                     #####                                  #
#                                    ##   ##                                 #
#                                   ##     ##                                #
#                                   #       #                                #
#                                   #       #                                #
#                                   #       #                                #
#                                   ##     ##                                #
#                                    ##   ##                                 #
#                                     #####                                  #
#                                                                            #
#                     ##########                 ##########                  #
#                    # -|-----> #               #    ->    #                 #
#                     ##########                 ##########                  #
#                                                                            #
#                                                                            #
##############################################################################