##############################################################################
#                        #                          #                        #
#                        #                          #                        #
#                        ############D###############                        #
#                                                                            #
#                                                                            #
#                                                                            #
#                                                                            #
#                                                                            #
#                                                                            #
#                                                                            #
#                                                                            #
#                                                                            #
#                                                                            #
#                                                                            #
#                                                                            #
#                                                                            #
#                                                                            #
#                                                                            #
#                                                                            #
#                                                                            #
#                                                                            #
#                                                                            #
#                                                                            #
#                                                                            #
##################################D###########################################
