##############################################################################
#                                                                            #
#                                                                            #
#                                                   ##                       #
#                                                   ##                       #
#                                                   ##                       #
#                                                   ##                       #
#                                                   ##                       #
#                                                   ##                       #
################         #####################################################
################         #####################################################
#                                                                            #
#                                                                            #
#                                                                            #
#                                                                            #
#                                                                            #
#                                                                            #
#                                                                            #
#                                                                            #
#                                                                            #
#                                                                            #
#                                                                            #
#                                                                            #
#                                                                            #
#                                                                            #
##################################D###########################################
