########################################E#####################################
#WWWWWWWWWWWWWWWWWWWWWWWWWWWWWWWWWWWW#     #WWWWWWWWWWWWWWWWWWWWWWWWWWWWWWWWWW
#WWWWWWWWWWWWWWWWWWWWWWWWWWWWWWWWWWWW#     #WWWWWWWWWWWWWWWWWWWWWWWWWWWWWWWWWW
#WWWWWWWWWWWWWWWWWWWWWWWWWWWWWWWWWWWW#     #WWWWWWWWWWWWWWWWWWWWWWWWWWWWWWWWWW
#WWWWWWWWWWWWWWWWWWWWWWWWWWWWWWWWWWWW#     #WWWWWWWWWWWWWWWWWWWWWWWWWWWWWWWWWW
#                                                                            #
#                                                                            #
#                                                                            #
#                                                                            #
#                                                                            #
#                                                                            #
#               ###                                                          #
#               ###                                                          #
#               #D#                                                          #
#                                                                            #
#                                              ###                           #
#                                              ###                           #
#                                              #D#                           #
#                                                                            #
#                                                                            #
#                                                                            #
#                                                                            #
#                        ###                                                 #
#                        ###                                                 #
#                        #D#                                                 #
#                                                                            #
#                                                                            #
#                                                                            #
#WWWWWWWWWWWWWWWWWWWWWWWWWWWWWWWWWWWWWWWWWWWWWWWWWWWWWWWWWWWWWWWWWWWWWWWWWWWW#
#WWWWWWWWWWWWWWWWWWWWWWWWWWWWWWWWWWWWWWWWWWWWWWWWWWWWWWWWWWWWWWWWWWWWWWWWWWWW#
#WWWWWWWWWWWWWWWWWWWWWWWWWWWWWWWWWWWWWWWWWWWWWWWWWWWWWWWWWWWWWWWWWWWWWWWWWWWW#
#WWWWWWWWWWWWWWWWWWWWWWWWWWWWWWWWWWWWWWWWWWWWWWWWWWWWWWWWWWWWWWWWWWWWWWWWWWWW#
#WWWWWWWWWWWWWWWWWWWWWWWWWWWWWWWWWWWWWWWWWWWWWWWWWWWWWWWWWWWWWWWWWWWWWWWWWWWW#
#WWWWWWWWWWWWWWWWWWWWWWWWWWWWWWWWWWWWWWWWWWWWWWWWWWWWWWWWWWWWWWWWWWWWWWWWWWWW#
#WWWWWWWWWWWWWWWWWWWWWWWWWWWWWWWWWWWWWWWWWWWWWWWWWWWWWWWWWWWWWWWWWWWWWWWWWWWW#
