#####################################E########################################
#                                                                            #
#                                                                            #
#                                                                            #
#                                                                            #
#                                                                            #
#                                                                            #
#                                                                            #
#                                                                            #
#                                                                            #
#                                                                            #
#                    GGGGGGGGGG                                              #
#                    ##################################                      #
#                    ##################################                      #
#                    GGGGGGGGGG                                              #
#                                            ###                             #
#                                            ###                             #
#                                            #D#                             #
#                GGGGGGGGGG                                                  #
#                GGGGGGGGGG                                                  #
###################################################                          #
###################################################                          #
#    GGGGGGGGGG              GGGGGGGGGG                                      #
#    GGGGGGGGGG              GGGGGGGGGG                                      #
#                                                                            #
#                                                GGGGGGGGGG                  #
#          GGG                                   GGGGGGGGGG                  #
#          GGG              ##################################################
#          GGG              ##################################################
#                           GGGGGGGGGG                        GGGGGGGGGG     #
#                           GGGGGGGGGG                        GGGGGGGGGG     #
#         GGGGG                                                              #
#         GGGGG                                                              #
#                                                                            #
####################################################################E#########
